به=>в
در=>в
به=>на
в=>به
в=>در
на=>به
با=>с
с=>با

Министерство Иностанных Дел=>وزارت امور خارجه
وزارت امور خارجه=>Министерство Иностанных Дел

посольство исламской республики Иран в республике Беларусь=>سفارت جمهوری اسلامی ایران در بلاروس
سفارت جمهوری اسلامی ایران در بلاروس=>посольство исламской республики Иран в республике Беларусь


свидительвуя свое уважение=>با ابراز تعارفات خود به
با ابراز تعارفات خود به=>свидительвуя свое уважение

وزارت کشور=>Министерство Внутренных Дел
Министерство Внутренных Дел=>وزارت کشور

и ссылаясь на =>پیرو
پیرو=>ссылаясь на

#و=>и
#и=>و

в ответ=>بازگشت
بازگشت=>в ответ

нота=>یادداشت
یادداشت=>нота


Посольство=>سفارت
سفارت=>Посольство
имеет честь сообщить следующее=>احتراما اشعار می دارد
احتراما اشعار می دارد=>имеет честь сообщить следующее

имеет честь=>احتراما
احتراما=>имеет честь

اشعار می دارد=>сообщить следующее
сообщить следующее=>اشعار می دارد

посольство пользуется случаем, чтобы=>موقع را مغتنم شمرده
موقع را مغتنم شمرده=>посольство пользуется случаем, чтобы

возобновить уверения в своем высоком уважении=>احترامات فائقه را تجدید می نماید
احترامات فائقه را تجدید می نماید=>возобновить уверения в своем высоком уважении

принимая во внимание=>با عنایت به
با عنایت به=>принимая во внимание
با توجه به=>принимая во внимание
با عنایت به اینکه=>принимая во внимание тот факт, что
принимая во внимание тот факт, что=>با عنایت به اینکه
Республика Беларусь=>جمهوری بلاروس
جمهوری بلاروس=>Республика Беларусь

Исламская Республика Иран=>جمهوری اسلامی ایران
جمهوری اسلامی ایران=>Исламская Республика Иран

Минск=>مینسک
مینسک=>Минск

Иран=>ایران
ایران=>Иран
Белаурсь=>بلاروس
بلاروس=>Беларусь

Владимир Макей=>ولادیمیر ماکی
ولادیمیر ماکی=>Владимир Макей


ایگور لیاشنکو=>Игорь Ляшенко
Игорь Ляшенко=>ایگور لیاشنکو

جناب آقای=>Е.П. г-н
Е.П. г-н=>جناب آقای

آقای=>г-н
г-н=>آقای

Е.П. г-н Посол=>سفیر محترم
سفیر محترم=>Е.П. г-н Посол

محترم=>уважаемый
уважаемый=>محترم

Министр иностранных дел=>وزیر امور خارجه
وزیر امور خارجه=>Министр иностранных дел

визит=>سفر
سفر=>визит
دیدار=>визит

недавний=>اخیر
недавнего=>اخیر
اخیر=>недавный 


بسمه تعالی=>Во имя Бога...
Во имя Бога...=>بسمه تعالی

کنسرسیوم بل نفت خیم=>концерн «Белнефтехим»
концерн «Белнефтехим=>کنسرسیوم بل نفت خیم
  
در نظر دارند=>желает
желает=>در نظر دارند
  
ملاقات نمایند=>встретиться
встретиться=>ملاقات نمایند

ملاقات=>встреча
встреча=>ملاقات		

همکاری های دوجانبه=>двусторонное сотдрудничество
двусторонное сотдрудничество=>همکاری های دوجانبه

همکاری های=>сотдрудничество
сотдрудничество=>همکاری های

دوجانبه=>двусторонное
двусторонное=>دوجانبه

همکاری=>сотдрудничество
сотдрудничество=>همکاری

میان=>между
между=>میان
بین=>между

هدف=>цель
цель=>هدف

с целью=>با هدف
هدف=>с целью

با هدف گفتگو=>с целью проведения переговоров
с целью проведения переговоров=>با هدف گفتگو

گفتگو=>проведение переговоров
проведение переговоров=>گفتگو

сфера=>زمینه 
زمینه=>сфера

امکان=>возможность
возможность=>امکان

انجام=>установление
установление=>انجام

رئیس محترم=>уважаемый председатель
уважаемый председатель=>رئیس محترم


موجب مزید امتنان خواهد بود=>Посольство будет признательно
Посольство будет признательно=>موجب مزید امتنان خواهد بود

برنامه ریزی و تعیین وقت ملاقات ایشان=>за организацию и назначение время встречи
за организацию и назначение встречи=>برنامه ریزی و تعیین وقت ملاقات ایشان

خواهشمند است=>Посольство будет признательно

پس از بررسی موضوع=>за рассмотрение вопроса и
за рассмотрение вопроса и=>پس از بررسی موضوع

نتیجه به این سفارت اعلام گردد=>уведомление Посольство о результате
уведомление Посольство о результате=>نتیجه به این سفارت اعلام گردد

اعلام گردد=>уведомить
уведомить=>اعلام گردد



    
    